100,100,100,100,100,,,,
100,100,100,100,100,100,,,
100,100,100,100,100,100,100,,
100,100,100,100,100,100,100,100,
101,101,101,101,101,101,101,101,201,
202,102,102,102,102,102,102,102,
100,100,100,100,100,100,100,,
100,100,100,100,100,100,,,
100,100,100,100,100,,,,
301,301,303,304,,,,,